Another way

#######E.#######
#..............#
#..##########..#
#..##########..#
#O............O#
###..##..##..###
#....##..##....#
#...O##..##O...#
#..####..####..#
#.###......###.#
#.#....OO....#.#
#..............#
#..##.....##...#
#..O#######O...#
#......T.......#
################

c-5,f-5
e-20
c-5,s-5,t-2
B-1
