Arena

########E#######
#..............#
#.O..........O.#
#..............#
#............O.#
#..............#
#....######....#
#....######....#
#.O............#
#..............#
#.....####.....#
#.....####.....#
#..............#
#.O..........O.#
#...........T..#
################

t-4
c-5
f-10
e-16
s-14
B-1
