Classic

####E###########
#..............#
#.O.....O......#
########.#.....#
#..O##..####O..#
#.O.....O......#
#...####.......#
#..........##..#
#....O..########
#..............#
#.O.........O..#
#....########..#
#....####..#...#
#.O......O#....#
#..T........#..#
################

s-5,e-5
c-12
e-10
t-5,f-5,s-5
B-1,c-2
