Corridors

##E#############
##............##
##.O..........O#
##............##
####..........##
####.O......O.##
####..........##
####..####...###
####..####...###
####.O......O###
####..........##
##............##
##.O..........O#
##............##
##..........T.##
################

e-5
c-2,f-2
s-3,f-3,e-3
c-2,f-2,s-2
B-1,s-2
