Maze

##E#############
#O........O....#
#..#.###O##....#
#.O#.##O.##....#
#..#.###.##....#
#..#..O........#
#..#####.#######
#.O#O..OTO..O..#
#..#...........#
#..#...O##O....#
#..#...........#
#.OO########...#
#......#.......#
#..............#
#.........#....#
################

s-5
c-5,f-2,t-2
t-10
e-7
c-3,f-5,s-2
s-10
B-1, e-7
