Nethack

################
###...######...#
#............E.#
#.#...O#####...#
#.#......####.##
#.#####.......##
#.#O###..####.##
#.....####.....#
#..............#
#.....####.....#
####.######.O###
####.######.####
#.....##......##
#.............##
#..T..O#......##
################

e-5
e-3,c-4
s-3,e-4,c-3
e-22
f-7,t-5
c-8,s-5
c-5,s-5,f-5,t-5
B-1,c-5,t-2,s-3,e-10
