SEALS

################
#......#.......E
#.O..#....O..#.#
#....#.#.....#.#
###.##.###.###.#
#..............#
#.###.####.###.#
#.#O.......O#..#
#.#...####...#.#
#.#...#..#...#.#
#.#...####...#.#
#.#..........#.#
#.###..##..###.#
#...#..O#..#...#
#T.....##.....O#
################

s-5
s-8
s-12
s-19
s-25
s-30
B-1,s-20